1111111111
1P00000001
1000E00111
1111111111
