1111111111
1P000000C1
1000E00111
1111111111
