1111111111
1P000001C1
1000E00111
1111111111
