1111111111111111111111111
1000000000000000000000001
1000000000000000000000001
1000000000000P10000000001
1000000000001110000000001
1000011110000000000000001
1000000000000000000000001
1000000111000000000000001
1000000000000111000000001
1110000000000000000000011
1000001110000000000000001
100000000000C000000000001
1000000000111110000000001
1000000001000000000000E01
1111111111111111111111111