1111111111111111111111111111111111111111
1000000000000000000000000000000000000001
1000000000000000000000000000000000000001
10000011110000000C0000000000000000000001
1000000000000000000000000000011100000001
111100000000P0000000100C010000000000C001
1C000CSSSS1111SSSS0000111100000000000E01
1111111111111111111111111111111111111111