1111111111111111111111111111111111111111
1000000000000000000000000000000000000001
1000000000000000000000000000000000000001
10000011110000000000000000C0000000000001
1P00000000000000000000000010000000000001
111100000000CCC00000000C010000000000C001
1C00000000000100000000111100000000000E01
1111111111111111111111111111111111111111