1111111111111111111111111111111111111111
1000000000000000000000000000000000000001
1000000000000000000000000000000000000001
1000001110000000000000000000000000000001
1010000000000000000000000000011100000001
111100000000P000000010000100000000000001
10C01000001111SSS000001111000000000000E1
1111111111111111111111111111111111111111