1111111111111111111111111111111111111111
1000000000000000000000000000000000000001
1000000C00000000000000000000000000000001
1000001110000000000000000000000000000001
1010000000000000000000000000011100000001
111100000000P0000000100C010000000000C001
1C000C00001111SSS00000111100000000000E01
1111111111111111111111111111111111111111