1111111111111111111111111111111111111111
1000000000000000000000000000000000000001
1000000000000000000000000000000000000001
1000001110000000000000000000000000000001
1C10000000000000000000000C00011100000001
111100000000P000000010000100000000000001
10C000M0001111SSS000001111000000000000E1
1111111111111111111111111111111111111111