1111111111111111111111111111111111111111
1000000000000000000000000000000000000001
1000000000000000000000000000000000000001
1000001111000000000000000000000000000001
1P00000000000000000000000000000000000001
11110000000000000000100C010000000000C001
1C000C0000000000000000111100000000000E01
1111111111111111111111111111111111111111