1111111111111111111111111111111111111111
1P00000000000000000000000000000000000001
1000000000000000000000000000000000000001
1000011101100000000000000000000000000001
1C100000000C00000000100000C0011100000001
1111000000000000000111100010000000000001
10C000000M01111SSS00000111100000000000E1
1111111111111111111111111111111111111111