1111111111111
1P000C000C001
1111101111101
1000000000001
1011111011111
1C000M000C0S1
1111111110111
1000000000001
10111S1111101
1C0M000C00001
11111111111E1
1000000000001
1111111111111