11111111111111111111111111111111111
10000000000000000000000000000000001
10000000000000000000000000000000001
100000000000000C0000000000000000001
10000000000000000000000000000000001
1000000000C00001C000000000000000001
1P000000000000110000000000C000000E1
11111100111111111111111111111111111
11111111111111111111111111111111111
