11111111111111111111111111111111111
10000000000000000000000000000000001
10000000000000000000000000000000001
100000P00000000C0000000000000000001
10000010100000001000000000000000001
1000000000C00001C000000000000000001
10000000000000110000000000C000000E1
11111111111111111111111111111111111
11111111111111111111111111111111111
